15,5,1,

01,02,02,02,02,02,02,02,02,02,02,02,02,02,03,
06,07,07,07,07,07,07,07,07,07,07,07,07,07,08,
06,07,07,07,07,07,07,07,07,07,07,07,07,07,08,
06,07,07,07,07,07,07,07,07,07,07,07,07,07,08,
11,12,12,12,12,12,12,12,12,12,12,12,10,07,08,