12,5,1,

01,02,02,02,02,02,02,02,02,02,02,15,
06,04,05,07,04,05,07,04,05,07,04,05,
06,04,05,07,04,05,07,04,05,07,04,05,
06,04,05,07,04,05,07,04,05,07,04,05,
11,12,12,12,12,12,12,12,12,12,12,10,
