12,5,1,

14,02,02,02,02,02,02,02,02,02,02,03,
07,04,05,07,04,05,07,04,05,07,04,08,
07,04,05,07,04,05,07,04,05,07,04,08,
07,04,05,07,04,05,07,04,05,07,04,08,
09,12,12,12,12,12,12,12,12,12,12,13,

