40,6,1,

01,02,02,02,02,02,02,02,02,02,02,02,02,02,02,02,02,02,02,15,04,05,07,04,14,02,02,02,02,02,02,02,02,02,02,02,02,02,02,03,
06,04,05,07,04,05,07,04,05,07,04,05,07,04,05,07,04,05,07,04,05,07,04,05,07,04,05,07,04,05,07,04,05,07,04,05,07,04,05,08,
06,05,07,04,05,07,04,05,07,04,05,07,04,05,07,04,05,07,04,05,07,04,05,07,04,05,07,04,05,07,04,05,07,04,05,07,04,05,07,08,
06,04,05,07,04,05,07,04,05,07,04,05,07,04,05,07,04,05,07,04,05,07,04,05,07,04,05,07,04,05,07,04,05,07,04,05,07,04,05,08,
06,05,07,04,05,07,04,05,07,04,05,07,04,05,07,04,05,07,04,05,07,04,05,07,04,05,07,04,05,07,04,05,07,04,05,07,04,05,07,08,
11,12,12,12,12,12,12,12,12,12,12,12,12,12,12,12,12,12,12,12,12,12,12,12,12,12,12,12,12,12,12,12,12,12,12,12,12,12,12,13,
