20,5,1,

01,02,02,02,02,02,02,02,02,02,02,02,02,02,02,02,02,02,02,03,
06,04,05,07,04,05,04,05,07,04,05,04,05,07,04,05,07,04,05,08,
06,05,07,04,05,07,05,07,04,05,07,05,07,04,05,07,04,05,07,08,
06,07,04,05,07,04,07,04,05,07,04,07,04,05,07,04,05,07,04,08,
11,12,12,12,12,12,12,12,12,12,12,12,12,12,12,12,12,12,12,13,
