20,5,1,

02,02,02,02,02,02,02,02,02,02,02,02,02,02,02,02,02,02,02,03,
04,05,07,04,05,07,04,05,07,04,05,07,04,05,07,04,05,07,04,08,
05,07,04,05,07,04,05,07,04,05,07,04,05,07,04,05,07,04,05,08,
07,04,05,07,04,05,07,04,05,07,04,05,07,04,05,07,04,05,07,08,
12,12,12,12,12,12,12,12,12,12,12,12,12,12,12,12,12,12,12,13,